################################################################################
#..............................................................................#
#..............................................................................#
#.................#################............................................#
#.................................#............................................#
#.................................#...........................#................#
#.................................#...........................#................#
#.................................#...........................#................#
#.................................#...........................#................#
#.................................#...........................#................#
#.............................................................#................#
#.............................................................#................#
#.....#########################################################................#
#.............................................................#................#
#.............................................................#................#
#.............................................................#................#
#.............................................................#................#
#.............................................................#................#
#.............................................................#................#
#......................................########################................#
#..............................................................................#
#..............................................................................#
#..............................................................................#
#...#..........................................................................#
#...#.........................................#................................#
#...#.........................................#................................#
#...#.........................................#................................#
#...#.........................................#................................#
#...#.........................................#................................#
#...#.........................................#................................#
#...#....................@....................###############..................#
#...#.........................................#................................#
#...#.........................................#................................#
#...#.........................................#................................#
#...#.........................................#................................#
#...#.........................................#................................#
#...#########################.................#................................#
#..............................................................................#
#..............................................................................#
################################################################################